                                  |
                                  |
                                  |
-                                -|
-                                -|
- p                              -|
-----                  -----     -|
-----ddd      - s s  s----ttt  kt-|
-------- -------------------------|
-------- -------------------------#