                                  |
                                  |
                                  |
-                                -|
-                                -|
- p                              -|
-----                  -----     -|
-----         - s s  s-------  k--|
-------- -------------------------|
-------- -------------------------#