--------- ''''---------|
-----------------------|
rrrrrrr--------rrrrrr--|
------rrrrrrrrrr----r--|
--------------------r--|
------------rrrrrrrrr--|
--rrr-------r----------|
--r-r-------r----------|
--r-r-------r----------|
--r-rrrrrrrrr----------|
--r--------------------|
--rrrrrrrrrrrrrrrrrrrrr|
-----------------------|
-----------------------#